border_size=1
usage=map

Xu          , Xu          , Xu          , Xu          , Xu          , Xu          , Qxu         , Xu          , Xu          , Xu          , Xu          , Xu          , Xu          , Xu          , Xu          , Xu          , Xu          , Xu          , Xu          , Xu          , Xu          , Xu          
Xu          , Xu          , Xu          , Xu          , Xu          , Qxu         , Qxu         , Xu          , Xu          , Xu          , Xu          , Xu          , Xu          , Xu          , Xu          , Xu          , Xu          , Xu          , Xu          , Xu          , Xu          , Xu          
Xu          , Xu          , Xu          , Xu          , Uu          , Uu          , Qxu^Bs\     , Xu          , Xu          , Xu          , Xu          , Xu          , Xu          , Xu          , Xu          , Xu          , Xu          , Xu          , Xu          , Xu          , Xu          , Xu          
Xu          , Xu          , Xu          , Uu          , Xu          , Qxu         , Xu          , Uu          , Uu          , Xu          , Uu          , Xu          , Uu          , Xu          , Xu          , Xu          , Xu          , Xu          , Xu          , Xu          , Xu          , Xu          
Xu          , Xu          , Uu          , Uu          , Xu          , Qxu         , Qxu         , Xu          , Xu          , Uu          , Xu          , Uu          , Xu          , Uu          , Uu          , Xu          , Xu          , Xu          , Xu          , Xu          , Xu          , Xu          
Xu          , Xu          , Uu          , Xu          , Xu          , Qxu         , Qxu         , Qxu         , Qxu         , Xu          , Uu          , Xu          , Xu          , Xu          , Uu          , Xu          , Xu          , Xu          , Xu          , Xu          , Xu          , Xu          
Xu          , Xu          , Xu          , Uu          , Xu          , Qxu         , Xu          , Xu          , Qxu         , Xu          , Uu          , Uu          , Uu          , Uu          , Xu          , Xu          , Xu          , Xu          , Xu          , Xu          , Xu          , Xu          
Xu          , Xu          , Uu          , Uu          , Xu          , Xu          , Qxu         , Xu          , Qxu         , Xu          , Uu          , Xu          , Xu          , Xu          , Xu          , Xu          , Xu          , Xu          , Xu          , Xu          , Xu          , Xu          
Xu          , Uu          , Xu          , Xu          , Xu          , Qxu         , Qxu         , Qxu         , Xu          , Xu          , Xu          , Xu          , Xu          , Xu          , Xu          , Xu          , Xu          , Xu          , Xu          , Xu          , Xu          , Xu          
Xu          , Uu          , Xu          , Xu          , Xu          , Qxu         , Qxu         , Xu          , Uu          , Xu          , Uu^Uf       , Xu          , Uu^Vud      , Uu          , Uh          , Xu          , Xu          , Xu          , Xu          , Xu          , Xu          , Xu          
Xu          , Xu          , Xu          , Xu          , Xu          , Qxu         , Qxu         , Uu          , Uu^Vud      , Uu          , Uu          , Uu^Uf       , Uu          , Uu          , Uu^Vu       , Qxu         , Qxu         , Uu          , Uu          , Xu          , Xu          , Xu          
Uu          , Uu          , Uu          , Xu          , Uu          , Qxu         , Qxu^Bs/     , Uu          , Uu          , Uu          , Uu^Vud      , Uu          , Uu          , Qxu         , Qxu         , Qxu^Bs\     , Uu          , Uu^Vu       , Uu          , Cud         , Cud         , Cud         
Uu          , Cud         , Cud         , Uu          , Uu^Vud      , Cud         , Qxu         , Qxu         , Uu          , Uu          , Uu          , Uu          , Uu          , Qxu^Bs\     , Uu^Vud      , Uu          , Uu          , Uu          , Uu          , Cud         , 1 Kud       , Cud         
Uu          , 2 Kud       , Cud         , Uu          , Uu          , Uu          , Cud         , Qxu^Bs/     , Qxu         , Uu          , Uu^Vu       , Uu          , Qxu         , Qxu         , Qxu         , Uu          , Uu          , Uu^Vud      , Uu          , Cud         , Cud         , Cud         
Uu          , Cud         , Uu          , Uu          , Uu^Vu       , Uu          , Uu          , Qxu         , Xu          , Uu          , Uh          , Uu          , Uu          , Qxu         , Qxu         , Xu          , Xu          , Uu          , Uu          , Cud         , Xu          , Cud         
Xu          , Uu^Vud      , Uu          , Uu          , Uu          , Uu          , Qxu         , Qxu         , Xu          , Xu          , Xu          , Uu          , Xu          , Xu          , Qxu         , Xu          , Xu          , Uu          , Qxu         , Uu          , Xu          , Xu          
Xu          , Xu          , Xu          , Xu          , Qxu         , Qxu^Bs\     , Uu          , Xu          , Xu          , Xu          , Xu          , Xu          , Xu          , Qxu         , Qxu         , Xu          , Uu          , Uu^Vu       , Uu          , Xu          , Xu          , Xu          
Xu          , Xu          , Xu          , Xu          , Qxu         , Uu          , Uu          , Uu          , Uu          , Xu          , Xu          , Xu          , Xu          , Xu          , Xu          , Qxu         , Uu          , Qxu         , Qxu         , Xu          , Xu          , Xu          
Xu          , Xu          , Qxu         , Qxu         , Xu          , Xu          , Xu          , Uu          , Uu^Vud      , Qxu         , Uu          , Uu          , Uu^Vu       , Xu          , Qxu         , Uh          , Uu          , Uu^Vud      , Xu          , Xu          , Xu          , Xu          
Xu          , Xu          , Xu          , Qxu         , Qxu         , Xu          , Xu          , Xu          , Xu          , Uu          , Uu          , Uu          , Qxu         , Uu          , Uu          , Qxu         , Uu          , Qxu         , Qxu         , Xu          , Xu          , Xu          
Xu          , Xu          , Qxu         , Qxu         , Xu          , Xu          , Xu          , Xu          , Xu          , Xu          , Xu          , Uu          , Xu          , Uh          , Xu          , Uu^Vud      , Xu          , Xu          , Qxu         , Xu          , Xu          , Xu          
Xu          , Xu          , Xu          , Qxu         , Xu          , Xu          , Xu          , Xu          , Xu          , Xu          , Xu          , Xu          , Xu          , Xu          , Xu          , Xu          , Xu          , Qxu         , Qxu         , Xu          , Xu          , Xu          
