border_size=1
usage=map

Gg          , Gs^Fp       , Gs^Fp       , Gs^Fp       , Gs^Fp       , Gs^Fp       , Gs^Fp       , Gs^Fp       , Rp          , Gs^Fp       , Gs^Fp       , Gs^Fp       , Gs^Fp       , Gs^Fp       , Gs^Fp       , Ww          , Gs^Fp       , Gs^Fp       , Gs^Fp       , Gs^Fp       , Gs^Fp       , Gs^Fp       
Gs^Fp       , Gs^Fp       , Gs^Fp       , Gs^Fp       , Gs^Fp       , Gg^Ve       , Gg          , Gs^Fp       , Rp          , Ce          , Ce          , Ce          , Gs^Fp       , Gs^Fp       , Gs^Fp       , Ww          , Gs^Fp       , Gs^Fp       , Gs^Fp       , Gs^Fp       , Gs^Fp       , Gs^Fp       
Gs^Fp       , Gs^Fp       , Gg^Vh       , Gs^Fp       , Gg          , Gg          , Gg          , Gg          , Rp          , Ce          , 2 Ke        , Ce          , Gg          , Gs^Fp       , Ww          , Ww          , Gg^Vh       , Gg          , Gg          , Gg^Ve       , Gs^Fp       , Gs^Fp       
Gs^Fp       , Gs^Fp       , Gg          , Gg          , Re^Gvs      , Re^Gvs      , Re^Gvs      , Gg          , Rp          , Ce          , Ce          , Ce          , Ww          , Ww^Bw\      , Gg          , Gg          , Re^Gvs      , Gg          , Re^Gvs      , Gg          , Rp          , Rp          
Gs^Fp       , Gs^Fp       , Gg          , Re^Gvs      , Re^Gvs      , Re^Gvs      , Gg          , Gg          , Rp          , Gg          , Ww          , Ww          , Wo          , Ww          , Ww          , Re^Gvs      , Re^Gvs      , Re^Gvs      , Rp          , Rp          , Hh          , Gg          
Hh          , Gg          , Hh          , Gg          , Gg          , Gg          , Gg          , Gg          , Rp          , Gg          , Ww          , Wo          , Wo          , Wo          , Ww          , Gg          , Rp          , Rp          , Mm^Xm       , Hh          , Mm^Xm       , Hh          
Mm          , Hh          , Hh          , Hh          , Hh^Vhh      , Gg          , Gg          , Gg          , Rp          , Gg          , Gg          , Ww          , Ww          , Ww          , Gg          , Rp          , Mm^Xm       , Mm^Xm       , Mm^Xm       , Mm^Xm       , Mm^Xm       , Mm^Xm       
Mm^Xm       , Mm          , Mm          , Hh          , Hh          , Hh          , Gg          , Gg          , Hh          , Rp          , Rp          , Rp          , Ww^Bw\      , Ww          , Ch          , Rp          , Mm^Xm       , Mm^Xm       , Mm^Xm       , Mm^Xm       , Xu          , Xu          
Mm^Xm       , Mm^Xm       , Mm^Xm       , Mm          , Mm          , Hh          , Hh          , Hh          , Mm^Xm       , Mm^Xm       , Gg          , Ch          , Ww          , Rp          , Rp          , Rp          , Ch          , Ch          , Xu          , Xu          , Xu          , Xu          
Mm          , Mm^Xm       , Mm^Xm       , Mm^Xm       , Mm^Xm       , Mm          , Mm          , Mm^Xm       , Mm          , Mm^Vhh      , Mm          , Gg          , Ww          , Gg          , Rp          , Ch          , Ch          , Ch          , 5 Kh        , Uu^Vud      , Xu          , Xu          
Mm          , Mm          , Mm^Xm       , Mm^Xm       , Mm^Xm       , Mm^Xm       , Mm^Xm       , Mm          , Mm^Vhh      , Mm          , Mm^Xm       , Mm^Vhh      , Rp          , Ww^Bw/      , Ww          , Mm          , Mm          , Ch          , Mm^Xm       , Xu          , Ww          , Ww          
Mm^Xm       , Mm^Xm       , Mm^Xm       , Mm^Xm       , Mm          , Mm^Xm       , Mm^Xm       , Mm          , Mm          , Mm          , Mm^Xm       , Mm          , Rp          , Gg          , Ww          , Gg^Vh       , Gg          , Mm^Xm       , Mm^Xm       , Ww          , Mm^Xm       , Mm^Xm       
Mm^Xm       , Mm^Xm       , Mm          , Mm          , Hh^Vhh      , Mm          , Mm          , Mm^Xm       , Mm^Xm       , Mm^Xm       , Mm^Xm       , Mm^Xm       , Re          , Ch          , Ww          , Gg          , Ch          , Mm^Xm       , Ww          , Ww          , Xu          , Xu          
Mm          , Mm          , Hh          , Hh          , Hh          , Hh          , Hh          , Mm          , Hh          , Mm^Xm       , Hh          , Gg          , Re          , Gg          , Gg          , Ww          , Ww          , Ww          , Cud         , Xu          , Xu          , Xu          
Hh          , Hh          , Hh          , Gg          , Gg          , Gg          , Hh          , Hh          , Ce          , Ce          , Ce          , Gg          , Re          , Gg          , Gg          , Gg          , Ww          , Cud         , Cud         , 1 Kud       , Uu^Vud      , Uu          
Gg          , Gg          , Gg          , Gg          , Gg          , Gg          , Gg          , Chr         , Ce          , 3 Ke        , Ce          , Gg          , Re          , Gg^Ve       , Gg          , Gg          , Ww          , Cud         , Cud         , Xu          , Xu          , Xu          
Gg          , Gg          , Gg          , Gg          , Gg          , Gg          , Gg^Vh       , Gg          , Gg          , Ce          , Chr         , Gg          , Re          , Gg          , Gg^Vh       , Gg          , Ww          , Gg          , Gg          , Gg          , Gg          , Xu          
Gg          , Gg^Vh       , Gg          , Gg          , Gg          , Gg          , Gg          , Gg          , Gg          , Gg          , Gg          , Gg          , Gg          , Re          , Re          , Gg          , Ww          , Gg          , Gg          , Gg          , Gg          , Gg          
Gg          , Gg          , Gg          , Gg^Vh       , Gg          , Gg          , Gg          , Gg          , Gg          , Gg          , Gg          , Gg          , Gg          , Chr         , Re          , Gg          , Chr         , Ww          , Ww          , Chr         , Gg          , Gg          
Gg          , Gg          , Gg          , Gg          , Gg          , Gg          , Gg          , Gg^Ve       , Gg          , Gg          , Gg^Vh       , Gg          , Gg          , Gg          , Re          , Gg          , Ww          , Ww          , Ce          , Gg          , Gg^Vh       , Gg          
Gg          , Gg          , Gg          , Gs^Fp       , Gs^Fp       , Gs^Fp       , Gs^Fp       , Gg          , Gg          , Gg          , Gg          , Gg          , Gg          , Gg          , Re          , Ww^Bw\      , Ce          , Ce          , 4 Ke        , Ce          , Ce          , Gg          
Gg          , Gg          , Gg          , Gs^Fp       , Gs^Fp       , Gs^Fp       , Gs^Fp       , Gs^Fp       , Gg          , Gg          , Gg          , Gg          , Gg          , Re          , Gg          , Ww          , Gg          , Gg          , Gg          , Gg          , Gg          , Gg          
