border_size=1
usage=map

Mm          , Mm          , Mm          , Mm          , Mm          , Mm          , Mm          , Mm          , Mm          , Mm          , Mm          , Mm          , Hh          , Ww          , Ww          , Rp          , Mm          , Mm          , Mm          , Mm          , Mm          , Mm          
Mm          , Mm          , Mm          , Mm          , Mm          , Mm          , Mm          , Mm          , Mm          , Mm^Vhh      , Mm          , Mm          , Ww          , Ww          , Ww^Bw/      , Rp          , Hh          , Mm^Vhh      , Mm          , Mm          , Mm          , Mm          
Mm          , Mm^Vhh      , Mm          , Mm          , Mm          , Mm^Vhh      , Mm          , Mm          , Mm          , Mm          , Hh          , Ww          , Ch          , Ch          , Ch          , Ww          , Hh          , Mm          , Mm          , Mm          , Mm^Vhh      , Mm          
Mm          , Mm          , Mm          , Mm          , Hh          , Mm          , Hh          , Hh          , Hh          , Hh          , Hh          , Ww          , Ch          , 2 Kh        , Ch          , Ww          , Hh          , Hh          , Hh^Vhh      , Mm          , Mm          , Mm          
Mm          , Mm          , Mm          , Hh          , Hh          , Hh^Vhh      , Hh          , Hh          , Hh          , Hh^Vhh      , Ww          , Ww          , Ww          , Ch          , Ww          , Ww          , Hh          , Hh          , Hh          , Mm          , Mm          , Mm          
Mm          , Mm^Vhh      , Hh          , Hh          , Hh          , Hh          , Hh          , Hh          , Hh          , Hh          , Ww          , Gg          , Gg          , Ww^Bw|      , Gg          , Gg          , Gg          , Hh          , Hh          , Hh          , Mm          , Mm          
Hh          , Hh          , Hh^Vhh      , Hh          , Hh          , Gg          , Gg          , Hh          , Gg          , Gg          , Ww          , Gg          , Rp          , Rp          , Gg          , Gg          , Gg          , Hh          , Hh          , Hh^Vhh      , Hh          , Mm          
Hh          , Hh          , Hh          , Hh          , Gg          , Gg          , Gg          , Gg          , Gs^Fp       , Gs^Fp       , Ww          , Gs^Fp       , Rp          , Gs^Fp       , Gs^Fp       , Gs^Fp       , Gs^Fp       , Gg          , Gg          , Hh          , Hh          , Gg          
Hh          , Hh          , Hh          , Gg          , Gg          , Gg          , Gs^Fp       , Gs^Fp       , Gs^Fp       , Gs^Fp       , Ww          , Gs^Fp       , Rp          , Gg^Fet      , Gs^Fp       , Gs^Fp       , Gs^Fp       , Gs^Fp       , Gs^Fp       , Gg          , Gs^Fp       , Gg          
Gg          , Hh          , Gg          , Gg          , Gg          , Gs^Fp       , Gs^Fp       , Gs^Fp       , Gs^Fp       , Gs^Fp       , Ww          , Gs^Fp       , Gg^Ve       , Rp          , Gg^Ve       , Gs^Fp       , Gs^Fp       , Gs^Fp       , Gs^Fp       , Gs^Fp       , Gs^Fp       , Gs^Fp       
Gg          , Gg          , Gg          , Gg          , Gs^Fp       , Gs^Fp       , Gg^Fet      , Gs^Fp       , Gs^Fp       , Gs^Fp       , Gg^Ve       , Ww          , Ww          , Ww^Bw|      , Ww          , Gg          , Gg^Ve       , Gs^Fp       , Gs^Fp       , Gs^Fp       , Gs^Fp       , Gs^Fp       
Gs^Fp       , Gg          , Gs^Fp       , Gs^Fp       , Gs^Fp       , Gs^Fp       , Gs^Fp       , Gs^Fp       , Gs^Fp       , Gg          , Gg          , Ww          , Cv          , Cv          , Cv          , Ww          , Gg          , Gg          , Gs^Fp       , Gs^Fp       , Gs^Fp       , Gs^Fp       
Gs^Fp       , Gs^Fp       , Gs^Fp       , Gs^Fp       , Gg^Ve       , Gs^Fp       , Gs^Fp       , Gs^Fp       , Gs^Fp       , Gg          , Gg^Ve       , Ww          , Cv          , 1 Kv        , Cv          , Ww          , Gg^Ve       , Gg          , Gs^Fp       , Gs^Fp       , Gs^Fp       , Gs^Fp       
Gs^Fp       , Gs^Fp       , Gs^Fp       , Gs^Fp       , Gs^Fp       , Gs^Fp       , Gs^Fp       , Gs^Fp       , Gs^Fp       , Gg          , Re          , Ww^Bw/      , Ww          , Cv          , Ww          , Ww^Bw\      , Rp          , Gg          , Gs^Fp       , Gs^Fp       , Gs^Fp       , Gs^Fp       
Ww          , Ww          , Ww          , Gs^Fp       , Gs^Fp       , Gs^Fp       , Gs^Fp       , Gs^Fp       , Re          , Re          , Gg          , Gg^Ve       , Gg          , Ww          , Gg^Ve       , Gg          , Rp          , Gs^Fp       , Gs^Fp       , Gs^Fp       , Gs^Fp       , Gs^Fp       
Gs^Fp       , Gs^Fp       , Ww          , Gg^Fet      , Ww          , Gs^Fp       , Gs^Fp       , Gs^Fp       , Re          , Gs^Fp       , Gs^Fp       , Gg          , Gg          , Ww          , Gg          , Gg          , Rp          , Gs^Fp       , Gs^Fp       , Gs^Fp       , Gs^Fp       , Gs^Fp       
Gs^Fp       , Gs^Fp       , Gs^Fp       , Ww          , Gs^Fp       , Ww          , Ww          , Gs^Fp       , Re          , Gs^Fp       , Gs^Fp       , Gs^Fp       , Ww          , Ww          , Gs^Fp       , Gs^Fp       , Rp          , Gs^Fp       , Gs^Fp       , Gs^Fp       , Gg^Fet      , Gs^Fp       
Gs^Fp       , Gs^Fp       , Gs^Fp       , Gs^Fp       , Gg^Ve       , Gs^Fp       , Re          , Re          , Ww          , Gs^Fp       , Gs^Fp       , Gs^Fp       , Ww          , Gs^Fp       , Gs^Fp       , Gs^Fp       , Rp          , Gs^Fp       , Hh          , Hh          , Gs^Fp       , Gs^Fp       
Gs^Fp       , Gs^Fp       , Gs^Fp       , Gs^Fp       , Gs^Fp       , Gs^Fp       , Re          , Gs^Fp       , Gs^Fp       , Ww          , Ww          , Gs^Fp       , Ww          , Gg^Ve       , Ce          , Gs^Fp       , Rp          , Hh          , Hh          , Hh          , Gs^Fp       , Gs^Fp       
Gs^Fp       , Gs^Fp       , Gg^Vh       , Gs^Fp       , Gs^Fp       , Gs^Fp       , Re          , Gs^Fp       , Gs^Fp       , Gs^Fp       , Gg^Fet      , Wo          , Gs^Fp       , Ce          , 3 Ke        , Ce          , Rp          , Hh          , Hh          , Hh          , Gs^Fp       , Gs^Fp       
Gs^Fp       , Gs^Fp       , Gs^Fp       , Gs^Fp       , Re          , Re          , Hh          , Hh          , Gs^Fp       , Gs^Fp       , Wo          , Wo          , Gs^Fp       , Ce          , Ce          , Ce          , Rp          , Gs^Fp       , Gs^Fp       , Gs^Fp       , Gs^Fp       , Gs^Fp       
Gs^Fp       , Gs^Fp       , Gs^Fp       , Gs^Fp       , Re          , Hh          , Hh^Vhh      , Hh          , Gs^Fp       , Gs^Fp       , Wo          , Gs^Fp       , Gg^Ve       , Gs^Fp       , Rp          , Rp          , Gs^Fp       , Gg^Ve       , Gs^Fp       , Gg^Fet      , Gs^Fp       , Gs^Fp       
Gs^Fp       , Gg^Vh       , Gs^Fp       , Gs^Fp       , Re          , Hh          , Hh          , Gs^Fp       , Gs^Fp       , Wo          , Gg^Fet      , Gs^Fp       , Gs^Fp       , Gs^Fp       , Rp          , Gs^Fp       , Gs^Fp       , Gs^Fp       , Gs^Fp       , Gs^Fp       , Gs^Fp       , Gs^Fp       
Gs^Fp       , Gs^Fp       , Re          , Re          , Gs^Fp       , Gs^Fp       , Gs^Fp       , Gs^Fp       , Gs^Fp       , Wo          , Gs^Fp       , Gs^Fp       , Rp          , Rp          , Gs^Fp       , Gs^Fp       , Gs^Fp       , Gg^Fet      , Gs^Fp       , Gs^Fp       , Gs^Fp       , Gs^Fp       
Re          , Re          , Gs^Fp       , Re          , Gs^Fp       , Gs^Fp       , Gg^Vh       , Gs^Fp       , Gs^Fp       , Wo          , Gs^Fp       , Gs^Fp       , Rp          , Gs^Fp       , Gs^Fp       , Gs^Fp       , Gs^Fp       , Gs^Fp       , Gs^Fp       , Gs^Fp       , Gs^Fp       , Gs^Fp       
Gs^Fp       , Gs^Fp       , Gs^Fp       , Re          , Gs^Fp       , Gs^Fp       , Gs^Fp       , Gs^Fp       , Wo          , Wo          , Ds          , Gs^Fp       , Rp          , Gg^Ve       , Gs^Fp       , Gs^Fp       , Gs^Fp       , Gs^Fp       , Gs^Fp       , Gs^Fp       , Gg^Ve       , Gs^Fp       
Gs^Fp       , Gs^Fp       , Gs^Fp       , Re          , Gs^Fp       , Gs^Fp       , Ds          , Ds          , Wo          , Ds          , Ww          , Ds          , Ww^Bw|      , Ds          , Ds          , Ds          , Ds          , Gs^Fp       , Gs^Fp       , Gs^Fp       , Gs^Fp       , Gs^Fp       
Gs^Fp       , Gg^Vh       , Gs^Fp       , Re          , Ds          , Ds          , Ww          , Wo          , Ww          , Ww          , Wo          , Ww          , Wo^Bw|      , Ww          , Ww          , Ww          , Ww          , Ds          , Ds          , Gs^Fp       , Ds          , Ds          
Gs^Fp       , Gs^Fp       , Ds          , Re          , Ww^Bw\      , Ww          , Wo          , Wo          , Wo          , Wo          , Ww          , Wo          , Ww^Bw|      , Wo          , Wo          , Wo          , Wo          , Ww          , Ww          , Ds          , Ww          , Ww          
Gs^Fp       , Ds          , Ww          , Ww          , Wo          , Wo^Bw\      , Ww^Bw\      , Ww          , Ww          , Ww          , Ds          , Ww          , Rp          , Ww          , Ww          , Ww          , Ww          , Wo          , Wo          , Ww          , Wo          , Wo          
Ds          , Ds          , Ww          , Wo          , Ww          , Ww          , Ww          , Ww^Bw\      , Re          , Ds          , Re          , Ds          , 4 Rp        , Ds          , Ds          , Ds          , Ds          , Ww          , Ww          , Wo          , Ww          , Ww          
Ww          , Ww          , Wo          , Wo          , Ww          , Ww          , Ds          , Ds          , Gs^Fp       , Re          , Gs^Fp       , Re          , Rp          , Gs^Fp       , Gg          , Gs^Fp       , Gs^Fp       , Ds          , Ds          , Ww          , Gs^Fp       , Gs^Fp       
