border_size=1
usage=map

Gg          , Gg          , Gg          , Gg          , Gg          , Gg          , Gg          , Gg          , Gg          , Gg          , Ww          , Gg          , Gg          , Gg          , Gg          , Gg          , Gg          , Gg          , Gg          , Gg          , Gg          , Gg          
Gg          , Gg          , Gg          , Gg          , Gg          , Gg          , Gg          , Gg          , Gg          , Gg          , Ww          , Gg          , Gg          , Gg          , Gg          , Gg          , Gg          , Gg          , Gg          , Gg          , Gg          , Gg          
Gg          , Gg          , Gg          , Gg          , Gg          , Gg          , Gg          , Gg          , Gg          , Gg          , Ww          , Gg          , Gg          , Gg          , Gg          , Gg          , Gg          , Gg          , Gg          , Gg          , Gg          , Gg          
Gg          , Gg          , Gg          , Gg          , Gg          , Gg          , Gg          , Gg          , Gg          , Gg          , Ww          , Gg          , Re          , Re          , Re          , Gg          , Gg          , Gg          , Gg          , Gg          , Gg          , Gg          
Gg          , Gg          , Gg          , Gg          , Gg          , Gg          , Gg          , Gg          , Ww          , Ww          , Gg          , Re          , Gg          , Gg^Ve       , Gg          , Rd          , Re          , Gg          , Gg^Vh       , Gg          , Gg          , Gg          
Rp          , Gg          , Gg          , Gg          , Gg          , Gg          , Gg          , Gg          , Ww          , Gg          , Gg^Vh       , Re          , Gg          , Gg          , Gg          , Gg          , Gg          , Re          , Re          , Gg          , Gg^Ve       , Gg          
Gg          , Rp          , Rp          , Gg          , Gg          , Gg          , Gg          , Gg          , Ww          , Gg          , Re          , Re          , Gg          , Gg          , Gg          , Gg          , Gg          , Gg          , Gg          , Re          , Re          , Gg          
Gg          , Gg          , Gg          , Rp          , Rp          , Gg          , Gg          , Gg          , Re          , Re          , Ce          , Gg          , Gg          , Gg          , Gg          , Gg          , Gg          , Gg          , Gg^Ve       , Gg          , Gg          , Re          
Gg          , Gg          , Gg          , Gg^Ve       , Gg          , Rp          , Rp          , Re          , Ww          , Ce          , 3 Ke        , Ce          , Ce          , Gg          , Gs^Fp       , Gg          , Gg          , Gg          , Gg          , Gg          , Gg          , Gg          
Gg          , Gg          , Gg          , Gg          , Gg          , Gg          , Rp          , Gg          , Ww          , Ce          , Ce          , Ce          , Gs^Fp       , Gs^Fp       , Gs^Fp       , Gs^Fp       , Hh^Fms      , Hh^Fms      , Hh^Fms      , Gg          , Gg          , Gg          
Gg          , Gg          , Gg          , Gg          , Gg          , Gg          , Rp          , Gg          , Ww          , Ce          , Ce          , Ce          , Gs^Fds      , Gs^Fds      , Hh^Fms      , Hh^Fms      , Hh^Fdf      , Hh^Fdf      , Hh^Fdf      , Hh^Fms      , Hh^Fms      , Gg          
Gg          , Gg          , Gg          , Gg          , Gg          , Gg          , Rp          , Gg          , Ww          , Ce          , Gs^Fdw      , Gs^Fdw      , Hh^Fdf      , Hh^Fms      , Hh^Fms      , Hh^Fdf      , Hh^Fdf      , Hh^Fdf      , Hh^Fms      , Hh^Fms      , Hh^Fms      , Gg          
Gg          , Gg          , Gg          , Gg          , Ww          , Ww          , Ww          , Ww^Bw\      , Rp          , Gs^Fdw      , Gs^Fdw      , Hh^Fdf      , Gs^Fdw      , Hh^Fdf      , Hh^Fms      , Hh^Vhh      , Mm          , Mm          , Mm          , Mm          , Mm          , Mm          
Gg          , Gg          , Gg          , Ww          , Ss          , Ss          , Ss          , Gg          , Rp          , Gs^Fdw      , Hh^Fdf      , Hh^Fdf      , Hh^Fdf      , Hh^Fdw      , Ww          , Mm          , Mm^Xm       , Mm          , Mm^Xm       , Mm          , Mm^Xm       , Mm^Xm       
Gg          , Gg^Vh       , Gg          , Ww          , Ss          , Ss          , Re^Gvs      , Rp          , Gg^Ve       , Gs^Fms      , Hh^Fdf      , Hh^Fdf      , Ww          , Ww          , Mm^Xm       , Mm^Xm       , Mm^Xm       , Mm^Xm       , Mm^Xm       , Mm^Xm       , Mm^Xm       , Mm^Xm       
Gg          , Gg          , Gg          , Ww          , Wwf         , Re^Gvs      , Re^Gvs      , Rp          , Rp          , Gs^Fms      , Ww          , Ww          , Hh          , Mm          , Mm          , Mm^Xm       , Mm          , Mm^Xm       , Mm^Xm       , Mm^Xm       , Xu          , Xu          
Gg          , Re          , Re          , Re          , Gg          , Wwf         , Ww          , Re^Gvs      , Ww          , Ww^Bw\      , Rr          , Mm          , Gg^Vh       , Hh          , Ww          , Hh          , Mm          , Mm^Xm       , Xu          , Xu          , Xu          , Xu          
Gg          , Gg          , Hh^Fmw      , Gg          , Hh^Fdw      , Hh^Fdf      , Hh^Fp       , Ww          , Ww          , Mm          , Ss          , Rr          , Ww^Bw\      , Ww          , Ww          , Mm^Vhh      , Xu          , Xu          , Xu          , Xu          , Xu          , Xu          
Hh^Fmw      , Ce          , Hh^Fmf      , Hh^Fms      , Hh^Fp       , Hh^Fp       , Mm          , Hh^Fmw      , Mm          , Ww          , Ww          , Ww          , Ww          , Ww^Bw\      , Cud         , Cud         , Uu          , Xu          , Xu          , Xu          , Xu          , Xu          
Hh^Fmw      , Ce          , Hh^Fmw      , Hh^Fms      , Hh^Fmw      , Hh^Fmw      , Mm          , Mm          , Mm          , Mm^Vhh      , Mm          , Mm          , Xu          , Cud         , Uu          , Uu^Vu       , Cud         , Cud         , Cud         , Xu          , Xu          , Xu          
Hh^Fmw      , 2 Ke        , Ce          , Hh^Fmw      , Hh^Fmw      , Mm          , Mm^Xm       , Mm^Xm       , Xu          , Xu          , Xu          , Xu          , Xu          , Xu          , Xu          , Cud         , Cud         , 1 Kud       , Cud         , Cud         , Uu^Vud      , Xu          
Gg          , Ce          , Hh^Fmw      , Hh^Fmw      , Mm          , Mm          , Mm^Xm       , Mm^Xm       , Xu          , Xu          , Xu          , Xu          , Xu          , Xu          , Xu          , Xu          , Xu          , Cud         , Uu          , Uu          , Uu          , Uu          
