border_size=1
usage=map

Mm          , Mm          , Mm          , Mm          , Mm          , Mm          , Mm          , Mm          , Mm          , Mm          , Mm          , Mm          , Mm          , Mm          , Mm          , Mm          , Mm          , Mm          , Mm          , Mm          , Mm          , Mm          
Mm          , Mm          , Mm          , Ch          , 5 Kh        , Ch          , Mm          , Mm          , Mm          , Mm          , Mm          , Mm          , Mm          , Mm          , Mm          , Mm          , Mm          , Mm          , Mm          , Mm          , Mm          , Mm          
Mm          , Mm          , Mm          , Ch          , Ch          , Ch          , Mm          , Mm          , Mm          , Mm          , Mm          , Mm          , Mm          , Mm          , Mm          , Mm          , Mm          , Mm          , Mm          , Mm          , Mm          , Mm          
Hh          , Mm          , Hh          , Mm          , Mm          , Mm          , Hh          , Hh          , Hh          , Hh          , Hh          , Hh          , Hh          , Hh          , Mm          , Mm          , Mm          , Mm          , Ch          , Ch          , Ch          , Mm          
Gg          , Hh          , Gg          , Hh          , Hh          , Hh          , Hh          , Hh          , Hh          , Hh          , Gg          , Gg          , Gg          , Hh          , Hh          , Mm          , Mm          , Mm          , Ch          , 3 Kh        , Ch          , Hh          
Ww          , Gg          , Ww          , Gg          , Re          , Re          , Re          , Gg          , Gg          , Gg          , Gg          , Gg          , Gg          , Gg          , Ww          , Ww          , Ww^Bw/      , Re          , Re          , Re          , Re          , Hh          
Re          , Ww          , Re          , Ww^Bw/      , Ww          , Gg          , Ww          , Re          , Re          , Gg          , Gg          , Gg          , Ww          , Ww          , Re          , Re          , Ch          , Ww          , Ww          , Ww          , Ww          , Re          
Hh          , Re          , Hh          , Gg          , Gg          , Ww          , Hh          , Ww          , Ww          , Re          , Ww^Bw\      , Ww          , Re          , Re          , Hh          , Ch          , 2 Kh        , Ch          , Hh          , Gg          , Hh          , Ww          
Ce          , Ce          , Ce          , Hh          , Hh          , Hh          , Mm          , Hh          , Hh          , Ww          , Gg          , Re          , Hh          , Hh          , Mm          , 4 Ch        , Ch          , Ch          , Mm          , Hh          , Hh          , Hh          
Ce          , 1 Ke        , Ce          , Mm          , Mm          , Mm          , Mm          , Mm          , Mm          , Hh          , Mm          , Hh          , Hh          , Hh          , Mm          , Mm          , Mm          , Mm          , Mm          , Mm          , Mm          , Hh          
Mm          , Ce          , Mm          , Mm          , Mm          , Mm          , Mm          , Mm          , Mm          , Mm          , Mm          , Mm          , Mm          , Mm          , Mm          , Mm          , Mm          , Mm          , Mm          , Mm          , Mm          , Mm          
Mm          , Mm          , Mm          , Mm          , Mm          , Mm          , Mm          , Mm          , Mm          , Mm          , Mm          , Mm          , Mm          , Mm          , Mm          , Mm          , Mm          , Mm          , Mm          , Mm          , Mm          , Mm          
